Rasgo adquirido: Un <b>rasgo adquirido</b> es una característica  adquirida por un organismo durante el transcurso de su vida, el cual no recibió de sus padres. Una cicatriz es un rasgo adquirido.

Adaptarse: <b>Adaptarse</b>  es cambiar. Cuando una población se adapta a un medio ambiente nuevo, los rasgos heredados que mejoran la habilidad de la población para sobrevivir y reproducirse son pasadas a las nuevas generaciones.

Adaptado: Cuando una población evoluciona a través de muchas generaciones, está se ha <b>adaptado</b>  mejor a su medio ambiente.

Adaptación: La <b>adaptación</b>  es el cambio de los rasgos heredados de una población a través de muchas generaciones, que mejora su habilidad de sobrevivir y reproducirse.

Ancestro: Un <b>ancestro</b>  es un padre, un abuelo y siguiendo así, regresándose a través de muchas generaciones.

Anual: Una planta <b>anual</b>  completa su ciclo de vida en una estación. El maíz y las maravillas son ambas ejemplos de plantas anuales. Las Plantas Misteriosas son plantas anuales también. 

Raza: Una <b>raza</b>  es un grupo dentro de una especie con rasgos comunes. Los sabuesos y los pastores alemanes son razas de perros.

Ancestros Comunes: Un <b>ancestro común</b>  es un ancestro que es compartido por diferentes organismos. Los primos comparten a un abuelo como ancestro común.

Datos: Los <b>datos</b>  son hechos o información reunida por científicos. Los científicos pueden graficar datos numéricos para ver información de una forma diferente.

Desierto: Un <b>desierto</b>  es una región donde hay muy poca lluvia.

Ecosistema: Un <b>ecosistema</b>  es un grupo de diferentes tipos de organismos que viven en un medio ambiente  particular.

Medio Ambiente: Un <b>medio ambiente</b>  es un lugar con ciertas características, tal como el tipo de suelo, clima, cantidad de lluvia o cantidad de luz solar.

Medios Ambientes: Un <b>medio ambiente</b>  es un lugar con ciertas características, tal como el tipo de suelo, clima, cantidad de lluvia o cantidad de luz solar.

Evolución:  La <b>evolución</b>  es el proceso por el cual poblaciones de organismos cambian su rasgos a través de muchas generaciones.

Evolucionar:  Cuando poblaciones de organismos cambian sus características  a través de varias generaciones, decimos que han <b>evolucionado</b>.

Extinto: <b>Extinto</b>  significa que una especie ha muerto en su totalidad. Los dinosaurios se extinguieron porque no existe uno vivo el día de hoy.

Extinción: La <b>extinction</b>  es la total desaparición de una especie.

Genes: Los <b>genes</b>  son el material que da a un organismo todas sus características heredadas.

Generación: Una <b>generación</b>  es un grupo de organismos viviendo al mismo tiempo. Los padres pertenecen a una generación y los niños a la siguiente generación.

Heredar: <b>Heredar</b>  significa recibir rasgos de los padres. Los niños heredan el color de los ojos de los padres.

Rasgo heredado: Un <b>rasgo heredado</b>  es una característica que es pasada a un organismo de los padres. El tamaño de hoja de las Plantas Misteriosas es un rasgo heredado.

Ciclo de vida: Un <b>ciclo de vida</b>  es una serie de etapas por las que pasa un organismo al crecer – desde una etapa inicial en un individuo hasta la misma etapa de sus crías.

Camada: Una <b>camada</b> es un grupo de bebés que nacen de los mismos padres al mismo tiempo.

Extinción masiva: Una <b>extinción masiva</b>  es un evento donde muchísimas plantas y animales se extinguen más o menos al mismo tiempo.

Hijos: Los hijos son los niños de un padre.

Hijas: Las hijas son las niñas de un padre.

Perennes: Las plantas <b>perennes</b>  viven por varios años. Los manzanos y los plátanos son ambos perennes.

Población: Una <b>población</b>  es un grupo de organismos viviendo en la misma área que tienen bebés entre sí.

Depredador: Un <b>depredador</b>  es un animal que se come a otros animales.

Reproducción: La <b>reproducción</b>  es el proceso en el que las plantas y los animals producen crías.

Brote: Un <b>brote</b>  es una planta joven.

Especie: Una <b>especie</b>  es un grupo de plantas o animales que comparten rasgos, viven en el mismo medio ambiente y pueden tener bebés juntos.

Rasgo: Un <b>rasgo</b>   es una característica o aspecto de una planta o animal. Rasgos tales como el color de ojos pueden ser heredados de los padres o adquiridos durante la vida, como una cicatriz.

Variación: <b>Variación</b>  significa las diferencias genéticas de padres a hijos y entre miembros de la misma especie. Un niño puede ser más alto o más bajo que sus padres, y los humanos tienen todos diferentes alturas.

Variedad: Una <b>variedad</b>  es un grupo de plantas dentro de la misma especie con características comunes. Hay muchas variedades diferentes de jitomates.